井原 勇一	ihara_yuuichi@example.com
柳田 佳乃	yanagida_yoshino@example.com
田端 ひとみ	tabata_hitomi@example.com
吉永 光洋	yoshinaga_mitsuhiro@example.com
ト字 勤	toji_tsutomu@example.com
前原 法子	maehara_noriko@example.com
吉田 沙耶	yoshida_saya@example.com
並木 大五郎	namiki_daigorou@example.com
松居 ひとり	matsui_hitori@example.com
滝 有起哉	taki_yukiya@example.com
村木 まさみ	muraki_masami@example.com
畠山 ケンイチ	hatayama_kenichi@example.com
長谷川 光	hasegawa_hikaru@example.com
大西 はるみ	oonishi_harumi@example.com
大山 雄太	ooyama_yuuta@example.com
河田 隆博	kawata_takahiro@example.com
戸塚 美帆	toduka_miho@example.com
久保 あい	kubo_ai@example.com
大津 貴嶺	ootsu_takane@example.com
西野 輝信	nishino_akinobu@example.com
畠中 勝久	hatanaka_katsuhisa@example.com
塚原 美嘉	tsukahara_mika@example.com
菅原 有起哉	sugawara_yukiya@example.com
大和 美和子	yamato_miwako@example.com
小高 美佐子	kodaka_misako@example.com
中里 さやか	nakazato_sayaka@example.com
野原 美幸	nohara_miyuki@example.com
芦田 基祐	ashida_kisuke@example.com
田所 めぐみ	tadokoro_megumi@example.com
戎 芽以	ebisu_mei@example.com
小西 コウ	konishi_kou@example.com
楠 陽子	kusunoki_youko@example.com
赤羽 一輝	akabane_kazuki@example.com
上原 由宇	uehara_yuu@example.com
山川 有起哉	yamakawa_yukiya@example.com
米谷 まひる	yoneya_mahiru@example.com
大平 麻緒	oohira_mao@example.com
鎌田 友以乃	kamata_yuino@example.com
パンツェッタ あや子	panzetta_ayako@example.com
高畑 聡	takahata_satoshi@example.com
宇田川 寿明	udagawa_toshiaki@example.com
相川 崇史	aikawa_takashi@example.com
高倉 きみまろ	takakura_kimimaro@example.com
高橋 直人	takahashi_naoto@example.com
横山 美智子	yokoyama_michiko@example.com
鹿島 綾女	kashima_ayame@example.com
池谷 禄郎	iketani_rokurou@example.com
石倉 真悠子	ishikura_mayuko@example.com
永山 未華子	nagayama_mikako@example.com
難波 完爾	nannba_kanji@example.com
倉持 瑠璃亜	kuramochi_ruria@example.com
真田 秀隆	sanada_hidetaka@example.com
樋口 洋介	higuchi_yousuke@example.com
金谷 美希	kanaya_miki@example.com
佐藤 光良	satou_teruyoshi@example.com
高瀬 路子	takase_michiko@example.com
米田 隆博	yoneda_takahiro@example.com
関根 まなみ	sekine_manami@example.com
福地 未華子	fukuchi_mikako@example.com
小菅 竜也	kosuge_tatsuya@example.com
目黒 満	meguro_mitsuru@example.com
吉岡 美月	yoshioka_miduki@example.com
寺島 那奈	terajima_nana@example.com
加藤 一	katou_hajime@example.com
久野 だん吉	hisano_dankichi@example.com
渡辺 豊	watanabe_yutaka@example.com
塚田 豊	tsukada_yutaka@example.com
赤羽 一恵	akabane_kadue@example.com
野崎 麻緒	nozaki_mao@example.com
飛田 季衣	hida_toshie@example.com
浅利 恵梨香	asari_erika@example.com
森永 恵子	morinaga_keiko@example.com
原口 あおい	haraguchi_aoi@example.com
岩間 碧海	iwama_ouga@example.com
今村 輝信	imamura_akinobu@example.com
堀北 亮介	horikita_ryousuke@example.com
小野 慶太	ono_keita@example.com
及川 勇介	oikawa_yuusuke@example.com
パンツェッタ 優	panzetta_yuu@example.com
松井 めぐみ	matsui_megumi@example.com
松井 聖陽	matsui_masaaki@example.com
沢村 一代	sawamura_kazuyo@example.com
松澤 季衣	matsuzawa_toshie@example.com
柳川 なつみ	yanagawa_natsumi@example.com
寺脇 弘也	terawaki_hironari@example.com
相川 美月	aikawa_miduki@example.com
釈 莉緒	shaku_rio@example.com
伊藤 賢二	itou_kenji@example.com
村瀬 崇史	murase_takashi@example.com
関根 裕司	sekine_yuuji@example.com
氏家 丈雄	ujiie_takeo@example.com
仲田 寿明	nakata_toshiaki@example.com
青野 雅彦	aono_masahiko@example.com
武藤 美佳	mutou_mika@example.com
神木 奈月	kamiki_natsuki@example.com
古谷 小百合	furutani_sayuri@example.com
岡山 さやか	okayama_sayaka@example.com
臼井 優	usui_yuu@example.com
有馬 菜々美	arima_nanami@example.com
山岡 信輔	yamaoka_shinsuke@example.com
